प्रमात्रा : quantum, quantity
सिद्धान्त : theory
सापेक्षता : relativity
आधुनिक : nodern
भौतिकी: physics
अनुप्रयोग : application
ऊष्मा : heat
ऊष्मीय : heat, thermal
ऊर्जा : energy
ताप : temprature, heat
प्रवाह : flows
पदार्थ : substance
गर्म : hot
ठंडे : cold
मात्रक : unit
जूल : joule
कैलोरी : calorie
ऊष्मा : heat
वस्तु: object
अन्तर्क्रियाओं : interactions
स्थानान्तरित : transfer
लोहे : iron
छड़ : road
पानी : water
ब्रह्माण्ड : entire universe
प्रकृति : nature
अध्ययन : study
वैज्ञानिक : scientific
प्राणिमात्र : living beings
वसन्त : spring
फूल :flower
वनस्पति : vegetation